0 0 0 0 3 0 0 0 0
0 0 0 I L I 0 0 0
0 0 2 2 2 2 2 0 0
0 2 2 2 2 2 2 2 0
1 1 1 1 1 1 1 1 1